XXXXXXXXXX
XE   /   X
X  XXXX  X
X  X   X X
X  XXX^X X
X X-X    X
X      X X
XXXXXXXX X
XS  /    X
XXXXXXXXXX